7,7,7,7,7,7,7,7,7,7,7,7,7,7,7,7,7,7,7
7,0,0,0,0,0,0,0,0,0,0,0,0,0,0,0,0,8,7
7,0,0,0,0,0,0,0,0,0,0,0,0,0,0,0,0,0,7
7,0,0,0,0,7,7,7,0,0,0,7,7,7,7,0,0,0,7
7,0,0,0,0,0,0,7,0,0,0,0,0,0,7,0,0,0,7
7,0,0,0,0,0,0,7,0,0,0,0,0,0,7,0,0,0,7
7,7,7,7,7,7,7,7,0,0,0,0,0,0,7,0,0,0,7
7,0,0,0,0,0,0,0,0,0,0,0,0,0,0,0,0,0,7
7,0,0,0,0,7,0,0,0,0,7,0,0,0,0,0,0,0,7
7,7,7,7,7,7,7,7,7,7,7,0,0,0,7,7,7,7,7
7,0,0,0,0,0,0,0,0,0,0,0,0,0,0,0,0,0,7
7,0,0,0,0,0,0,0,0,0,0,0,0,0,0,0,0,0,7
7,0,12,7,0,0,0,7,0,0,0,0,0,0,0,0,0,0,7
7,0,0,7,0,0,0,7,0,0,0,0,0,0,0,0,0,0,7
7,0,0,0,0,0,0,0,0,0,0,7,7,7,7,7,7,7,7
7,0,0,0,0,0,0,0,0,0,0,7,0,0,0,0,0,11,7
7,7,7,7,7,7,7,7,0,0,0,7,0,0,0,0,0,0,7
7,0,0,0,0,0,0,0,0,0,0,0,0,0,0,7,0,0,7
7,0,0,0,0,0,0,0,0,0,0,0,0,0,0,0,0,0,7
7,7,7,7,7,7,7,7,7,7,7,7,7,7,7,7,7,7,7