7,7,7,7,7,7,7,7
7,0,0,0,0,0,0,7
7,0,0,0,0,0,0,7
7,12,0,0,7,0,0,7
7,0,0,0,7,0,0,7
7,7,7,7,7,0,0,7
7,11,0,0,0,0,0,7
7,0,0,0,0,0,0,7
7,7,7,7,7,7,7,7
